1111111111111111111111111
100000000000111CCCCCCC111
1PCCCCC00000CCCCC10001111
1E1111111M1111CC110001001
100111111111110CCC11110M1
1C00000000000000001111111
1111111111111111111111111